7 9
1 1 1 1 1 1 1 1 1
1 1 1 -1 3 2 1 0 1
1 -2 1 0 1 -2 0 1 1
1 1 1 1 5 7 1 1 1
1 1 0 1 5 7 0 1 1
1 1 1 1 4 7 0 1 1
1 1 1 -2 1 6 1 1 1
