9 7
1 1 1 1 1 1 1 1 1
1 -1 1 1 1 1 1 1 1
1 0 0 0 0 0 0 3 1
1 0 0 0 0 0 0 3 -2
1 0 0 0 0 0 0 2 -2
1 -2 -2 1 1 1 1 1 1
4 5 5 5 5 5 1 1 0 1
